# libfuzzer keyword dictionary used for fuzzing grub.cfg 
echocmd="echo"
if="if"
then="then"
else="else"
fi="fi"
for="for"
do="do"
done="done"
function="function"
set="set"
default="default"
insmod="insmod"
timeout="timeout"
search="search"
searchfile="search.file"
searchfslabel="search.fs_label"
searchfsuuid="search.fs_uuid"
fileflag="--file"
fslabelflag="--fs-label"
fsuuidflag="--fs-uuid"
root="root"
nofloppy="no-floppy"
hint="hint"
menuentry="menuentry"
class-flag="-class"
configfile="configfile"
linux="linux"
linux16="linux16"
linuxefi="linuxefi"
initrd="initrd"
initrd16="initrd16"
initrdefi="initrdefi"
multiboot="multiboot"
module="module"
nounzip="--nounzip"
label2="LABEL="
xdriver="xdriver="
separator=":"
randomimage="/images/pxeboot/vmlinuz"
serial="serial"
terminal_input"terminal_input"
terminal_output="terminal_output"
gfxpayload="gfxpayload"
blsconfig="blscfg"
