# libfuzzer keyword dictionary used for fuzzing gosh
true="true"
false="false"
exit="exit"
set="set"
shift="shift"
unset="unset"
echo="echo"
printf="printf"
break="break"
continue="continue"
pwd="pwd"
cd="cd"
builtin="builtin"
eval="eval"
source="source"
openingBracket="["
closingBracket="]"
test="test"
exec="exec"
command="command"
dirs="dirs"
pushd="pushd"
popd="popd"
return="return"
read="read"
getopts="getopts"
shopts="shopts"
alias="alias"
unalias="unalias"
trap="trap"
type="type"
flag1="-e"
flag2="-n"
flag3="-E"
flag4="-a"
flag5="-f"
flag6="-P"
flag7="-p"
flag8="-t"
flag9="-r"
flag10="-s"
flag11="-o"
flag12="-q"
flag13="-l"
help="--help"
flagExpr="-"
flagExpr2="--"