path="path"
include="include"
default="default"
prompt="prompt"
menu="menu"
display="display"
color="color"
help="help"
label="label"
linux="linux"
kernel="kernel"
append="append"
initrd="initrd"
initrd_param="initrd="
randomimage="initrd.img"
vmlinuz="vmlinuz"
separator="separator"
begin="begin"
root="root"
separator2=":"
cdlabel="CDLABEL"
comment="# "
include="include"
ui="ui"
sysappend="sysappend"
boot="boot"
bss="bss"
comboot"comboot"
com32="com32"
fdimage="fdimage"
pxe="pxe"
config="config"
localboot="localboot"
serial="serial"
nohalt="nohalt"
console="console"
sendcookies="sendcookies"
timeout="timeout"
tottaltimeout="tottaltimeout"
ontimeout="ontimeout"
allowoptions="allowoptions"
nocomplete="nocomplete"
noescape="noescape"
onerror="onerror"
prompt="prompt"
kbdmap="kbdmap"
font="font"
say="say"
f1="f1"
f3="f3"
f12="f12"
zero="0"
